NO ./Textures/Psychedelic_NORTH.xpm
WE ./Textures/Psychedelic_WEST.xpm
EA ./Textures/Psychedelic_EAST.xpm
SO ./Textures/Psychedelic_SOUTH.xpm
DO ./Textures/Psychedelic_DOOR.xpm

F 41,173,237
C 0,0,255
M 249,0,137
P 249,0,137
R 0,255,255

        1111111111111111111111111
        1000000000110000000000001
        1011000001110000030000001
        1001000000200000000000001
111111111011000001110000000000001
100000000011000001112111111111111
11110111111111011100000010001
11110111111111011101010010001
11000000110101011100000030001
10000000000000001100000000001
10000000000000001101S10000001
1100000111010101111101111000111
11110111 1110101 101111010001
11111111 1111111 111111111111