NO textures/brick.xpm
SO textures/brick.xpm
WE textures/brick.xpm
EA textures/brick.xpm

F 41,173,237
C 0,0,255


111
111

          11111
          11111
