NO textures/brick.xpm
SO textures/brick.xpm
WE textures/brick.xpm
EA textures/brick.xpm

DO ./Textures/Psychedelic_DOOR.xpm

F 41,173,237
C 0,0,255
M 249,0,137
P 249,0,137
R 0,255,255

        111111111111111111111111111111111
        10 0 0 0 0 0 0 0 0110000000000001
        101100000111000000000000111111111
        1001000000000000000000001
111111111011000001110000000000001
100000000011000001110111111111111
11110111111111011100000010001
11110111111111011101010010001
11000000110101011100000010001
10000000000000001100000010001
10000000000000001101010010001
11000001110101011111011110N0111
11110111 1110101 101111010001
11111111 1111111 111111111111
