NO ./Textures/Psychedelic_NORTH.xpm
SO ./Textures/Psychedelic_SOUTH.xpm
WE ./Textures/Psychedelic_WEST.xpm
EA ./Textures/Psychedelic_EAST.xpm

F 41,173,237
C 0,0,255

111111111111
100110000001
100110000001
101110100001
100000000011
100000010001
100100101001
10010N000011
111111111111